
..........
..E.....X.
..........
..........
.....N....
..........
.M.......H
..........
..........
.....G....