
..........
..X.....M.
..........
..........
.....G....
..........
.H.......E
..........
..........
.....N....