
..........
..G.....H.
..........
..........
.....N....
..........
.M.......E
..........
..........
.....X....