..........
..H.....X.
..........
..........
.....N....
.........