
..........
..G.....N.
..........
..........
.....X....
..........
.M.......H
..........
..........
.....E....