..........
..N.....G.
..........
..........
.....E....
....