
..........
..M.....H.
..........
..........
.....N....
..........
.X.......G
..........
..........
.....E....