
..........
..N.....M.
..........
..........
.....X....
..........
.H.......E
..........
..........
.....G....