
..........
..H.....M.
..........
..........
.....E....
..........
.N.......X
..........
..........
.....G....