
..........
..N.....H.
..........
..........
.....X....
..........
.E.......M
..........
..........
.....G....