
..........
..G.....N.
..........
..........
.....M....
..........
.H.......E
..........
..........
.....X....