
..........
..M.....H.
..........
..........
.....N....
..........
.G.......E
..........
..........
.....X....