
..........
..G.....E.
..........
..........
.....N....
..........
.H.......X
..........
..........
.....M....