
..........
..H.....X.
..........
..........
.....E....
..........
.G.......M
..........
..........
.....N....