..........
..E.....N.
..........
..........
.....X....
..........
.M.......H
..........
..........
.....G.