
..........
..E.....X.
..........
..........
.....M....
..........
.H.......N
..........
..........
.....G....