..........
..M.....X.
..........
..........
.....H....
..........
.G.......E
..........
..........
..