
..........
..E.....H.
..........
..........
.....N....
..........
.X.......M
..........
..........
.....G....