
..........
..X.....M.
..........
..........
.....H....
..........
.N.......G
..........
..........
.....E....