
..........
..X.....G.
..........
..........
.....N....
..........
.H.......E
..........
..........
.....M....