
..........
..N.....X.
..........
..........
.....H....
..........
.G.......E
..........
..........
.....M....