..........
..G.....X.
..........
..........
.....H....
..........
.E.......M
..........
..........
.