
..........
..N.....H.
..........
..........
.....X....
..........
.M.......G
..........
..........
.....E....