
..........
..X.....M.
..........
..........
.....H....
..........
.E.......G
..........
..........
.....N....