
..........
..E.....N.
..........
..........
.....H....
..........
.M.......X
..........
..........
.....G....