..........
..........
..E....X..
..........
..........
..........
..........
..G....M..
.........